{
  "version": 2,
  "matrix": [
    "11111111111111111111111111111111111111111",
    "10000000000010000000000000000000000000001",
    "10000000000010000000000000000000000000001",
    "10000000000010000000000000000000000000001",
    "10001111100010001111111110001111111110001",
    "10000000100010000000100000001000000010001",
    "10000000100010000000100000001000000010001",
    "10000000100010000000100000001000000010001",
    "11111000100011111000100011111000100010001",
    "10001000100000000000100000001000100010001",
    "10001000100000000000100000001000100010001",
    "10001000100000000000100000001000100010001",
    "10001000111111111111111110001000111110001",
    "10001000000000001000100000001000000000001",
    "10001000000000001000100000001000000000001",
    "10001000000000001000100000001000000000001",
    "10001111111110001000100011111000111111111",
    "10000000000000000000100010000000000010001",
    "10000000000000000000100010000000000010001",
    "10000000000000000000100010000000000010001",
    "10001111111111111111100011111111100010001",
    "10001000100000000000100010000000100000001",
    "10001000100000000000100010000000100000001",
    "10001000100000000000100010000000100000001",
    "10001000100011111000100010001000111111111",
    "10001000100010000000100000001000100000001",
    "10001000100010000000100000001000100000001",
    "10001000100010000000100000001000100000001",
    "10001000100011111111100011111000100010001",
    "10000000100010000000000000001000000010001",
    "10000000100010000000000000001000000010001",
    "10000000100010000000000000001000000010001",
    "11111000100011111111111111111111111110001",
    "10001000100010000000100000000000000010001",
    "10001000100010000000100000000000000010001",
    "10001000100010000000100000000000000010001",
    "10001000100010001000100011111111100010001",
    "10000000100000001000000010000000000000001",
    "10000000100000001000000010000000000000001",
    "10000000100000001000000010000000000000001",
    "11111111111111111111111111111111111111111"
  ],
  "decorations": {},
  "blankFloorTiles": {},
  "floorTileMap": {},
  "entryNodes": {
    "start": {
      "x": 37,
      "y": 1,
      "gate": {
        "x": 37,
        "y": 0
      }
    },
    "end": {
      "x": 1,
      "y": 37,
      "gate": {
        "x": 1,
        "y": 40
      }
    }
  },
  "entryType": null
}
